1,0,0,0,0,0,0,0,0,0,0,0,0,0,0,0,0,0,0,5,0,0,0,0,1,3,3,3,3,1
1,0,0,0,0,1,0,0,0,0,0,1,0,0,0,1,0,0,0,1,1,0,0,0,1,4,4,4,4,1
1,0,0,0,0,0,0,0,0,0,0,0,0,0,0,0,0,0,0,0,0,1,1,0,2,4,4,4,4,2
1,0,0,0,0,0,0,0,0,0,0,0,0,0,0,0,0,0,0,0,0,0,0,0,2,4,4,4,4,2
1,0,0,0,0,5,0,0,0,0,0,0,0,0,0,0,0,1,1,2,0,0,0,0,2,4,4,4,4,2
1,0,0,0,1,1,0,0,0,0,0,0,0,1,0,0,0,0,0,0,2,0,0,0,2,2,2,2,2,2
1,0,0,0,1,1,0,0,0,0,0,0,1,2,0,0,0,0,0,0,0,0,2,2,2,2,2,2,2,2
1,0,0,0,0,0,0,0,0,0,0,1,2,2,0,0,0,6,0,0,0,6,0,0,0,0,0,0,0,2
1,0,0,5,5,0,0,5,0,1,1,2,2,2,0,0,0,0,0,0,0,0,0,0,0,0,0,0,0,2
1,1,1,1,1,1,1,1,1,1,2,2,2,2,2,2,2,2,2,2,2,2,2,2,2,3,3,3,3,2
2,2,2,2,2,2,2,2,2,2,2,2,2,2,2,2,2,2,2,2,2,2,2,2,2,4,4,4,4,2