☺,☻,♥,♦,♣
♠,•,◘,○,◙
♂,♀,♪,♫,☼
►,◄,↕,‼,¶
§,▬,↨,↑,↓
→,←,∟,↔,▲
▼,!,",#,$
%,&,■,(,)
*,+,-,.,/