],^,_,`,a
b,c,d,e,f
g,h,i,j,k
l,m,n,o,p
q,r,s,t,u
v,w,x,y,z
{,|,},~,⌂
Ç,ü,é,â,ä
à,å,ç,ê,ë